{
	"numX": 13,
	"numY": 9,
	"size": [64, 64],
	"start": [32, 32],
	"tilenames": ["", "ProtoCoin", "ProtoBox", "tile01", "ProtoBat","tile02","tile03", "tile04"],
	"tiles": [0, 0, 0, 0, 0, 0, 0, 0, 0, 0, 0, 0, 0,
			  0, 4, 0, 0, 0, 0, 0, 0, 0, 0, 0, 4, 0,
			  0, 0, 1, 0, 0, 0, 0, 0, 0, 1, 0, 0, 0,
			  0, 1, 2, 0, 0, 0, 0, 0, 0, 2, 1, 0, 0,
			  0, 2, 2, 0, 0, 0, 0, 0, 0, 2, 2, 0, 0,
			  1, 7, 7, 0, 0, 0, 0, 0, 0, 7, 7, 1, 0,
			  1, 6, 0, 0, 6, 1, 1, 1, 0, 6, 0, 1, 0,
			  3, 3, 3, 3, 3, 3, 3, 3, 3, 3, 3, 3, 3,
			  5, 5, 5, 5, 5, 5, 5, 5, 5, 5, 5, 5, 5]
}
			 